"a" = (/turf/unsimulated/floor/black,/area/space)
"R" = (/turf/unsimulated/floor/orange,/area/space)

(1,1,1) = {"
RaRaRaRaRaRaRaRaRaRaRaRaRaRaRaRaRaRaRaRaRaRaRaRaRaRaRaRaRaRaRaRaRaRaRaRaRaRaRaRaRaRaRaRaRaRaRaRaRaRa
aRaRaRaRaRaRaRaRaRaRaRaRaRaRaRaRaRaRaRaRaRaRaRaRaRaRaRaRaRaRaRaRaRaRaRaRaRaRaRaRaRaRaRaRaRaRaRaRaRaR
RaRaRaRaRaRaRaRaRaRaRaRaRaRaRaRaRaRaRaRaRaRaRaRaRaRaRaRaRaRaRaRaRaRaRaRaRaRaRaRaRaRaRaRaRaRaRaRaRaRa
aRaRaRaRaRaRaRaRaRaRaRaRaRaRaRaRaRaRaRaRaRaRaRaRaRaRaRaRaRaRaRaRaRaRaRaRaRaRaRaRaRaRaRaRaRaRaRaRaRaR
RaRaRaRaRaRaRaRaRaRaRaRaRaRaRaRaRaRaRaRaRaRaRaRaRaRaRaRaRaRaRaRaRaRaRaRaRaRaRaRaRaRaRaRaRaRaRaRaRaRa
aRaRaRaRaRaRaRaRaRaRaRaRaRaRaRaRaRaRaRaRaRaRaRaRaRaRaRaRaRaRaRaRaRaRaRaRaRaRaRaRaRaRaRaRaRaRaRaRaRaR
RaRaRaRaRaRaRaRaRaRaRaRaRaRaRaRaRaRaRaRaRaRaRaRaRaRaRaRaRaRaRaRaRaRaRaRaRaRaRaRaRaRaRaRaRaRaRaRaRaRa
aRaRaRaRaRaRaRaRaRaRaRaRaRaRaRaRaRaRaRaRaRaRaRaRaRaRaRaRaRaRaRaRaRaRaRaRaRaRaRaRaRaRaRaRaRaRaRaRaRaR
RaRaRaRaRaRaRaRaRaRaRaRaRaRaRaRaRaRaRaRaRaRaRaRaRaRaRaRaRaRaRaRaRaRaRaRaRaRaRaRaRaRaRaRaRaRaRaRaRaRa
aRaRaRaRaRaRaRaRaRaRaRaRaRaRaRaRaRaRaRaRaRaRaRaRaRaRaRaRaRaRaRaRaRaRaRaRaRaRaRaRaRaRaRaRaRaRaRaRaRaR
RaRaRaRaRaRaRaRaRaRaRaRaRaRaRaRaRaRaRaRaRaRaRaRaRaRaRaRaRaRaRaRaRaRaRaRaRaRaRaRaRaRaRaRaRaRaRaRaRaRa
aRaRaRaRaRaRaRaRaRaRaRaRaRaRaRaRaRaRaRaRaRaRaRaRaRaRaRaRaRaRaRaRaRaRaRaRaRaRaRaRaRaRaRaRaRaRaRaRaRaR
RaRaRaRaRaRaRaRaRaRaRaRaRaRaRaRaRaRaRaRaRaRaRaRaRaRaRaRaRaRaRaRaRaRaRaRaRaRaRaRaRaRaRaRaRaRaRaRaRaRa
aRaRaRaRaRaRaRaRaRaRaRaRaRaRaRaRaRaRaRaRaRaRaRaRaRaRaRaRaRaRaRaRaRaRaRaRaRaRaRaRaRaRaRaRaRaRaRaRaRaR
RaRaRaRaRaRaRaRaRaRaRaRaRaRaRaRaRaRaRaRaRaRaRaRaRaRaRaRaRaRaRaRaRaRaRaRaRaRaRaRaRaRaRaRaRaRaRaRaRaRa
aRaRaRaRaRaRaRaRaRaRaRaRaRaRaRaRaRaRaRaRaRaRaRaRaRaRaRaRaRaRaRaRaRaRaRaRaRaRaRaRaRaRaRaRaRaRaRaRaRaR
RaRaRaRaRaRaRaRaRaRaRaRaRaRaRaRaRaRaRaRaRaRaRaRaRaRaRaRaRaRaRaRaRaRaRaRaRaRaRaRaRaRaRaRaRaRaRaRaRaRa
aRaRaRaRaRaRaRaRaRaRaRaRaRaRaRaRaRaRaRaRaRaRaRaRaRaRaRaRaRaRaRaRaRaRaRaRaRaRaRaRaRaRaRaRaRaRaRaRaRaR
RaRaRaRaRaRaRaRaRaRaRaRaRaRaRaRaRaRaRaRaRaRaRaRaRaRaRaRaRaRaRaRaRaRaRaRaRaRaRaRaRaRaRaRaRaRaRaRaRaRa
aRaRaRaRaRaRaRaRaRaRaRaRaRaRaRaRaRaRaRaRaRaRaRaRaRaRaRaRaRaRaRaRaRaRaRaRaRaRaRaRaRaRaRaRaRaRaRaRaRaR
RaRaRaRaRaRaRaRaRaRaRaRaRaRaRaRaRaRaRaRaRaRaRaRaRaRaRaRaRaRaRaRaRaRaRaRaRaRaRaRaRaRaRaRaRaRaRaRaRaRa
aRaRaRaRaRaRaRaRaRaRaRaRaRaRaRaRaRaRaRaRaRaRaRaRaRaRaRaRaRaRaRaRaRaRaRaRaRaRaRaRaRaRaRaRaRaRaRaRaRaR
RaRaRaRaRaRaRaRaRaRaRaRaRaRaRaRaRaRaRaRaRaRaRaRaRaRaRaRaRaRaRaRaRaRaRaRaRaRaRaRaRaRaRaRaRaRaRaRaRaRa
aRaRaRaRaRaRaRaRaRaRaRaRaRaRaRaRaRaRaRaRaRaRaRaRaRaRaRaRaRaRaRaRaRaRaRaRaRaRaRaRaRaRaRaRaRaRaRaRaRaR
RaRaRaRaRaRaRaRaRaRaRaRaRaRaRaRaRaRaRaRaRaRaRaRaRaRaRaRaRaRaRaRaRaRaRaRaRaRaRaRaRaRaRaRaRaRaRaRaRaRa
aRaRaRaRaRaRaRaRaRaRaRaRaRaRaRaRaRaRaRaRaRaRaRaRaRaRaRaRaRaRaRaRaRaRaRaRaRaRaRaRaRaRaRaRaRaRaRaRaRaR
RaRaRaRaRaRaRaRaRaRaRaRaRaRaRaRaRaRaRaRaRaRaRaRaRaRaRaRaRaRaRaRaRaRaRaRaRaRaRaRaRaRaRaRaRaRaRaRaRaRa
aRaRaRaRaRaRaRaRaRaRaRaRaRaRaRaRaRaRaRaRaRaRaRaRaRaRaRaRaRaRaRaRaRaRaRaRaRaRaRaRaRaRaRaRaRaRaRaRaRaR
RaRaRaRaRaRaRaRaRaRaRaRaRaRaRaRaRaRaRaRaRaRaRaRaRaRaRaRaRaRaRaRaRaRaRaRaRaRaRaRaRaRaRaRaRaRaRaRaRaRa
aRaRaRaRaRaRaRaRaRaRaRaRaRaRaRaRaRaRaRaRaRaRaRaRaRaRaRaRaRaRaRaRaRaRaRaRaRaRaRaRaRaRaRaRaRaRaRaRaRaR
RaRaRaRaRaRaRaRaRaRaRaRaRaRaRaRaRaRaRaRaRaRaRaRaRaRaRaRaRaRaRaRaRaRaRaRaRaRaRaRaRaRaRaRaRaRaRaRaRaRa
aRaRaRaRaRaRaRaRaRaRaRaRaRaRaRaRaRaRaRaRaRaRaRaRaRaRaRaRaRaRaRaRaRaRaRaRaRaRaRaRaRaRaRaRaRaRaRaRaRaR
RaRaRaRaRaRaRaRaRaRaRaRaRaRaRaRaRaRaRaRaRaRaRaRaRaRaRaRaRaRaRaRaRaRaRaRaRaRaRaRaRaRaRaRaRaRaRaRaRaRa
aRaRaRaRaRaRaRaRaRaRaRaRaRaRaRaRaRaRaRaRaRaRaRaRaRaRaRaRaRaRaRaRaRaRaRaRaRaRaRaRaRaRaRaRaRaRaRaRaRaR
RaRaRaRaRaRaRaRaRaRaRaRaRaRaRaRaRaRaRaRaRaRaRaRaRaRaRaRaRaRaRaRaRaRaRaRaRaRaRaRaRaRaRaRaRaRaRaRaRaRa
aRaRaRaRaRaRaRaRaRaRaRaRaRaRaRaRaRaRaRaRaRaRaRaRaRaRaRaRaRaRaRaRaRaRaRaRaRaRaRaRaRaRaRaRaRaRaRaRaRaR
RaRaRaRaRaRaRaRaRaRaRaRaRaRaRaRaRaRaRaRaRaRaRaRaRaRaRaRaRaRaRaRaRaRaRaRaRaRaRaRaRaRaRaRaRaRaRaRaRaRa
aRaRaRaRaRaRaRaRaRaRaRaRaRaRaRaRaRaRaRaRaRaRaRaRaRaRaRaRaRaRaRaRaRaRaRaRaRaRaRaRaRaRaRaRaRaRaRaRaRaR
RaRaRaRaRaRaRaRaRaRaRaRaRaRaRaRaRaRaRaRaRaRaRaRaRaRaRaRaRaRaRaRaRaRaRaRaRaRaRaRaRaRaRaRaRaRaRaRaRaRa
aRaRaRaRaRaRaRaRaRaRaRaRaRaRaRaRaRaRaRaRaRaRaRaRaRaRaRaRaRaRaRaRaRaRaRaRaRaRaRaRaRaRaRaRaRaRaRaRaRaR
RaRaRaRaRaRaRaRaRaRaRaRaRaRaRaRaRaRaRaRaRaRaRaRaRaRaRaRaRaRaRaRaRaRaRaRaRaRaRaRaRaRaRaRaRaRaRaRaRaRa
aRaRaRaRaRaRaRaRaRaRaRaRaRaRaRaRaRaRaRaRaRaRaRaRaRaRaRaRaRaRaRaRaRaRaRaRaRaRaRaRaRaRaRaRaRaRaRaRaRaR
RaRaRaRaRaRaRaRaRaRaRaRaRaRaRaRaRaRaRaRaRaRaRaRaRaRaRaRaRaRaRaRaRaRaRaRaRaRaRaRaRaRaRaRaRaRaRaRaRaRa
aRaRaRaRaRaRaRaRaRaRaRaRaRaRaRaRaRaRaRaRaRaRaRaRaRaRaRaRaRaRaRaRaRaRaRaRaRaRaRaRaRaRaRaRaRaRaRaRaRaR
RaRaRaRaRaRaRaRaRaRaRaRaRaRaRaRaRaRaRaRaRaRaRaRaRaRaRaRaRaRaRaRaRaRaRaRaRaRaRaRaRaRaRaRaRaRaRaRaRaRa
aRaRaRaRaRaRaRaRaRaRaRaRaRaRaRaRaRaRaRaRaRaRaRaRaRaRaRaRaRaRaRaRaRaRaRaRaRaRaRaRaRaRaRaRaRaRaRaRaRaR
RaRaRaRaRaRaRaRaRaRaRaRaRaRaRaRaRaRaRaRaRaRaRaRaRaRaRaRaRaRaRaRaRaRaRaRaRaRaRaRaRaRaRaRaRaRaRaRaRaRa
aRaRaRaRaRaRaRaRaRaRaRaRaRaRaRaRaRaRaRaRaRaRaRaRaRaRaRaRaRaRaRaRaRaRaRaRaRaRaRaRaRaRaRaRaRaRaRaRaRaR
RaRaRaRaRaRaRaRaRaRaRaRaRaRaRaRaRaRaRaRaRaRaRaRaRaRaRaRaRaRaRaRaRaRaRaRaRaRaRaRaRaRaRaRaRaRaRaRaRaRa
aRaRaRaRaRaRaRaRaRaRaRaRaRaRaRaRaRaRaRaRaRaRaRaRaRaRaRaRaRaRaRaRaRaRaRaRaRaRaRaRaRaRaRaRaRaRaRaRaRaR
RaRaRaRaRaRaRaRaRaRaRaRaRaRaRaRaRaRaRaRaRaRaRaRaRaRaRaRaRaRaRaRaRaRaRaRaRaRaRaRaRaRaRaRaRaRaRaRaRaRa
aRaRaRaRaRaRaRaRaRaRaRaRaRaRaRaRaRaRaRaRaRaRaRaRaRaRaRaRaRaRaRaRaRaRaRaRaRaRaRaRaRaRaRaRaRaRaRaRaRaR
RaRaRaRaRaRaRaRaRaRaRaRaRaRaRaRaRaRaRaRaRaRaRaRaRaRaRaRaRaRaRaRaRaRaRaRaRaRaRaRaRaRaRaRaRaRaRaRaRaRa
aRaRaRaRaRaRaRaRaRaRaRaRaRaRaRaRaRaRaRaRaRaRaRaRaRaRaRaRaRaRaRaRaRaRaRaRaRaRaRaRaRaRaRaRaRaRaRaRaRaR
RaRaRaRaRaRaRaRaRaRaRaRaRaRaRaRaRaRaRaRaRaRaRaRaRaRaRaRaRaRaRaRaRaRaRaRaRaRaRaRaRaRaRaRaRaRaRaRaRaRa
aRaRaRaRaRaRaRaRaRaRaRaRaRaRaRaRaRaRaRaRaRaRaRaRaRaRaRaRaRaRaRaRaRaRaRaRaRaRaRaRaRaRaRaRaRaRaRaRaRaR
RaRaRaRaRaRaRaRaRaRaRaRaRaRaRaRaRaRaRaRaRaRaRaRaRaRaRaRaRaRaRaRaRaRaRaRaRaRaRaRaRaRaRaRaRaRaRaRaRaRa
aRaRaRaRaRaRaRaRaRaRaRaRaRaRaRaRaRaRaRaRaRaRaRaRaRaRaRaRaRaRaRaRaRaRaRaRaRaRaRaRaRaRaRaRaRaRaRaRaRaR
RaRaRaRaRaRaRaRaRaRaRaRaRaRaRaRaRaRaRaRaRaRaRaRaRaRaRaRaRaRaRaRaRaRaRaRaRaRaRaRaRaRaRaRaRaRaRaRaRaRa
aRaRaRaRaRaRaRaRaRaRaRaRaRaRaRaRaRaRaRaRaRaRaRaRaRaRaRaRaRaRaRaRaRaRaRaRaRaRaRaRaRaRaRaRaRaRaRaRaRaR
RaRaRaRaRaRaRaRaRaRaRaRaRaRaRaRaRaRaRaRaRaRaRaRaRaRaRaRaRaRaRaRaRaRaRaRaRaRaRaRaRaRaRaRaRaRaRaRaRaRa
aRaRaRaRaRaRaRaRaRaRaRaRaRaRaRaRaRaRaRaRaRaRaRaRaRaRaRaRaRaRaRaRaRaRaRaRaRaRaRaRaRaRaRaRaRaRaRaRaRaR
RaRaRaRaRaRaRaRaRaRaRaRaRaRaRaRaRaRaRaRaRaRaRaRaRaRaRaRaRaRaRaRaRaRaRaRaRaRaRaRaRaRaRaRaRaRaRaRaRaRa
aRaRaRaRaRaRaRaRaRaRaRaRaRaRaRaRaRaRaRaRaRaRaRaRaRaRaRaRaRaRaRaRaRaRaRaRaRaRaRaRaRaRaRaRaRaRaRaRaRaR
RaRaRaRaRaRaRaRaRaRaRaRaRaRaRaRaRaRaRaRaRaRaRaRaRaRaRaRaRaRaRaRaRaRaRaRaRaRaRaRaRaRaRaRaRaRaRaRaRaRa
aRaRaRaRaRaRaRaRaRaRaRaRaRaRaRaRaRaRaRaRaRaRaRaRaRaRaRaRaRaRaRaRaRaRaRaRaRaRaRaRaRaRaRaRaRaRaRaRaRaR
RaRaRaRaRaRaRaRaRaRaRaRaRaRaRaRaRaRaRaRaRaRaRaRaRaRaRaRaRaRaRaRaRaRaRaRaRaRaRaRaRaRaRaRaRaRaRaRaRaRa
aRaRaRaRaRaRaRaRaRaRaRaRaRaRaRaRaRaRaRaRaRaRaRaRaRaRaRaRaRaRaRaRaRaRaRaRaRaRaRaRaRaRaRaRaRaRaRaRaRaR
RaRaRaRaRaRaRaRaRaRaRaRaRaRaRaRaRaRaRaRaRaRaRaRaRaRaRaRaRaRaRaRaRaRaRaRaRaRaRaRaRaRaRaRaRaRaRaRaRaRa
aRaRaRaRaRaRaRaRaRaRaRaRaRaRaRaRaRaRaRaRaRaRaRaRaRaRaRaRaRaRaRaRaRaRaRaRaRaRaRaRaRaRaRaRaRaRaRaRaRaR
RaRaRaRaRaRaRaRaRaRaRaRaRaRaRaRaRaRaRaRaRaRaRaRaRaRaRaRaRaRaRaRaRaRaRaRaRaRaRaRaRaRaRaRaRaRaRaRaRaRa
aRaRaRaRaRaRaRaRaRaRaRaRaRaRaRaRaRaRaRaRaRaRaRaRaRaRaRaRaRaRaRaRaRaRaRaRaRaRaRaRaRaRaRaRaRaRaRaRaRaR
RaRaRaRaRaRaRaRaRaRaRaRaRaRaRaRaRaRaRaRaRaRaRaRaRaRaRaRaRaRaRaRaRaRaRaRaRaRaRaRaRaRaRaRaRaRaRaRaRaRa
aRaRaRaRaRaRaRaRaRaRaRaRaRaRaRaRaRaRaRaRaRaRaRaRaRaRaRaRaRaRaRaRaRaRaRaRaRaRaRaRaRaRaRaRaRaRaRaRaRaR
RaRaRaRaRaRaRaRaRaRaRaRaRaRaRaRaRaRaRaRaRaRaRaRaRaRaRaRaRaRaRaRaRaRaRaRaRaRaRaRaRaRaRaRaRaRaRaRaRaRa
aRaRaRaRaRaRaRaRaRaRaRaRaRaRaRaRaRaRaRaRaRaRaRaRaRaRaRaRaRaRaRaRaRaRaRaRaRaRaRaRaRaRaRaRaRaRaRaRaRaR
RaRaRaRaRaRaRaRaRaRaRaRaRaRaRaRaRaRaRaRaRaRaRaRaRaRaRaRaRaRaRaRaRaRaRaRaRaRaRaRaRaRaRaRaRaRaRaRaRaRa
aRaRaRaRaRaRaRaRaRaRaRaRaRaRaRaRaRaRaRaRaRaRaRaRaRaRaRaRaRaRaRaRaRaRaRaRaRaRaRaRaRaRaRaRaRaRaRaRaRaR
RaRaRaRaRaRaRaRaRaRaRaRaRaRaRaRaRaRaRaRaRaRaRaRaRaRaRaRaRaRaRaRaRaRaRaRaRaRaRaRaRaRaRaRaRaRaRaRaRaRa
aRaRaRaRaRaRaRaRaRaRaRaRaRaRaRaRaRaRaRaRaRaRaRaRaRaRaRaRaRaRaRaRaRaRaRaRaRaRaRaRaRaRaRaRaRaRaRaRaRaR
RaRaRaRaRaRaRaRaRaRaRaRaRaRaRaRaRaRaRaRaRaRaRaRaRaRaRaRaRaRaRaRaRaRaRaRaRaRaRaRaRaRaRaRaRaRaRaRaRaRa
aRaRaRaRaRaRaRaRaRaRaRaRaRaRaRaRaRaRaRaRaRaRaRaRaRaRaRaRaRaRaRaRaRaRaRaRaRaRaRaRaRaRaRaRaRaRaRaRaRaR
RaRaRaRaRaRaRaRaRaRaRaRaRaRaRaRaRaRaRaRaRaRaRaRaRaRaRaRaRaRaRaRaRaRaRaRaRaRaRaRaRaRaRaRaRaRaRaRaRaRa
aRaRaRaRaRaRaRaRaRaRaRaRaRaRaRaRaRaRaRaRaRaRaRaRaRaRaRaRaRaRaRaRaRaRaRaRaRaRaRaRaRaRaRaRaRaRaRaRaRaR
RaRaRaRaRaRaRaRaRaRaRaRaRaRaRaRaRaRaRaRaRaRaRaRaRaRaRaRaRaRaRaRaRaRaRaRaRaRaRaRaRaRaRaRaRaRaRaRaRaRa
aRaRaRaRaRaRaRaRaRaRaRaRaRaRaRaRaRaRaRaRaRaRaRaRaRaRaRaRaRaRaRaRaRaRaRaRaRaRaRaRaRaRaRaRaRaRaRaRaRaR
RaRaRaRaRaRaRaRaRaRaRaRaRaRaRaRaRaRaRaRaRaRaRaRaRaRaRaRaRaRaRaRaRaRaRaRaRaRaRaRaRaRaRaRaRaRaRaRaRaRa
aRaRaRaRaRaRaRaRaRaRaRaRaRaRaRaRaRaRaRaRaRaRaRaRaRaRaRaRaRaRaRaRaRaRaRaRaRaRaRaRaRaRaRaRaRaRaRaRaRaR
RaRaRaRaRaRaRaRaRaRaRaRaRaRaRaRaRaRaRaRaRaRaRaRaRaRaRaRaRaRaRaRaRaRaRaRaRaRaRaRaRaRaRaRaRaRaRaRaRaRa
aRaRaRaRaRaRaRaRaRaRaRaRaRaRaRaRaRaRaRaRaRaRaRaRaRaRaRaRaRaRaRaRaRaRaRaRaRaRaRaRaRaRaRaRaRaRaRaRaRaR
RaRaRaRaRaRaRaRaRaRaRaRaRaRaRaRaRaRaRaRaRaRaRaRaRaRaRaRaRaRaRaRaRaRaRaRaRaRaRaRaRaRaRaRaRaRaRaRaRaRa
aRaRaRaRaRaRaRaRaRaRaRaRaRaRaRaRaRaRaRaRaRaRaRaRaRaRaRaRaRaRaRaRaRaRaRaRaRaRaRaRaRaRaRaRaRaRaRaRaRaR
RaRaRaRaRaRaRaRaRaRaRaRaRaRaRaRaRaRaRaRaRaRaRaRaRaRaRaRaRaRaRaRaRaRaRaRaRaRaRaRaRaRaRaRaRaRaRaRaRaRa
aRaRaRaRaRaRaRaRaRaRaRaRaRaRaRaRaRaRaRaRaRaRaRaRaRaRaRaRaRaRaRaRaRaRaRaRaRaRaRaRaRaRaRaRaRaRaRaRaRaR
RaRaRaRaRaRaRaRaRaRaRaRaRaRaRaRaRaRaRaRaRaRaRaRaRaRaRaRaRaRaRaRaRaRaRaRaRaRaRaRaRaRaRaRaRaRaRaRaRaRa
aRaRaRaRaRaRaRaRaRaRaRaRaRaRaRaRaRaRaRaRaRaRaRaRaRaRaRaRaRaRaRaRaRaRaRaRaRaRaRaRaRaRaRaRaRaRaRaRaRaR
RaRaRaRaRaRaRaRaRaRaRaRaRaRaRaRaRaRaRaRaRaRaRaRaRaRaRaRaRaRaRaRaRaRaRaRaRaRaRaRaRaRaRaRaRaRaRaRaRaRa
aRaRaRaRaRaRaRaRaRaRaRaRaRaRaRaRaRaRaRaRaRaRaRaRaRaRaRaRaRaRaRaRaRaRaRaRaRaRaRaRaRaRaRaRaRaRaRaRaRaR
RaRaRaRaRaRaRaRaRaRaRaRaRaRaRaRaRaRaRaRaRaRaRaRaRaRaRaRaRaRaRaRaRaRaRaRaRaRaRaRaRaRaRaRaRaRaRaRaRaRa
aRaRaRaRaRaRaRaRaRaRaRaRaRaRaRaRaRaRaRaRaRaRaRaRaRaRaRaRaRaRaRaRaRaRaRaRaRaRaRaRaRaRaRaRaRaRaRaRaRaR
"}
