//MAP CONVERTED BY dmm2tgm.py THIS HEADER COMMENT PREVENTS RECONVERSION, DO NOT REMOVE
"aA" = (
/turf/simulated/wall/auto/jen/red,
/area/station/security/brig/genpop)
"aG" = (
/obj/decal/poster/wallsign/stencil_ru/left/er{
	pixel_x = -11
	},
/obj/decal/poster/wallsign/stencil_ru/right/a{
	pixel_x = 2
	},
/turf/simulated/wall/auto/reinforced/jen/red,
/area/space)
"aN" = (
/turf/simulated/wall/auto/supernorn,
/area/space)
"bz" = (
/obj/disposalpipe/segment/brig,
/turf/simulated/floor/red/redblackchecker,
/area/space)
"cf" = (
/turf/simulated/floor/redblack/corner{
	dir = 8
	},
/area/space)
"cM" = (
/obj/machinery/port_a_brig,
/turf/simulated/floor/black,
/area/space)
"cN" = (
/obj/disposalpipe/trunk/brig,
/obj/machinery/floorflusher/minibrig,
/turf/simulated/floor/grime,
/area/space)
"cY" = (
/turf/simulated/floor/grime,
/area/station/security/brig/genpop)
"dD" = (
/obj/disposalpipe/trunk/brig,
/obj/machinery/floorflusher/minibrig2,
/turf/simulated/floor/grime,
/area/space)
"eb" = (
/obj/stool/chair/office/red{
	dir = 8
	},
/turf/simulated/floor/red,
/area/space)
"en" = (
/turf/simulated/floor/red/redblackchecker,
/area/space)
"ez" = (
/turf/simulated/floor/redblack{
	dir = 4
	},
/area/space)
"eH" = (
/obj/shrub{
	dir = 4;
	icon = 'icons/obj/stationobjs.dmi';
	icon_state = "plant"
	},
/obj/disposaloutlet,
/obj/disposalpipe/trunk/brig{
	dir = 4
	},
/turf/simulated/floor/redblack/corner,
/area/space)
"fi" = (
/obj/table/reinforced/auto,
/obj/machinery/door/airlock/pyro/glass/windoor{
	dir = 4
	},
/turf/simulated/floor/red,
/area/station/security/processing{
	name = "Security Dispatch"
	})
"fJ" = (
/obj/table/reinforced/auto,
/turf/simulated/floor/black,
/area/space)
"ik" = (
/obj/disposalpipe/junction/left/south,
/turf/simulated/floor/grime,
/area/station/security/brig/genpop)
"in" = (
/obj/wingrille_spawn/reinforced_crystal/full,
/obj/disposalpipe/segment/brig,
/turf/simulated/floor/plating,
/area/space)
"ku" = (
/turf/simulated/floor/redblack{
	dir = 4
	},
/area/station/security/processing{
	name = "Security Dispatch"
	})
"lB" = (
/turf/space,
/area/space)
"lG" = (
/obj/machinery/door/airlock/pyro/security/alt,
/turf/simulated/floor/grime,
/area/space)
"lN" = (
/obj/item/storage/toilet{
	dir = 8
	},
/turf/simulated/floor/grime,
/area/space)
"nl" = (
/turf/simulated/floor/black,
/area/station/security/processing{
	name = "Security Dispatch"
	})
"nI" = (
/obj/machinery/drainage/big,
/obj/machinery/shower,
/turf/simulated/floor/grime,
/area/space)
"nM" = (
/obj/disposalpipe/segment/brig{
	dir = 8;
	icon_state = "pipe-c"
	},
/turf/simulated/floor/black,
/area/space)
"nR" = (
/obj/machinery/door/airlock/pyro/glass/security{
	req_access = null
	},
/turf/simulated/floor/grime,
/area/space)
"og" = (
/turf/simulated/floor/black{
	icon_state = "respect5"
	},
/area/space)
"pY" = (
/turf/simulated/floor/redblack{
	dir = 9
	},
/area/space)
"qg" = (
/obj/machinery/computer3/generic/secure_data{
	dir = 8
	},
/turf/simulated/floor/redblack{
	dir = 6
	},
/area/station/security/processing{
	name = "Security Dispatch"
	})
"sd" = (
/turf/simulated/floor/black{
	icon_state = "respect4"
	},
/area/space)
"ue" = (
/obj/reagent_dispensers/watertank/fountain,
/turf/simulated/floor/redblack/corner{
	dir = 4
	},
/area/space)
"ul" = (
/turf/simulated/floor/redblack{
	dir = 8
	},
/area/station/security/processing{
	name = "Security Dispatch"
	})
"uI" = (
/obj/machinery/door/airlock/pyro/glass/security{
	req_access = null
	},
/turf/simulated/floor/black,
/area/space)
"uL" = (
/turf/simulated/floor/redblack{
	dir = 6
	},
/area/space)
"vx" = (
/turf/simulated/floor/black{
	icon_state = "respect2"
	},
/area/space)
"vS" = (
/turf/simulated/floor/redblack/corner{
	dir = 1
	},
/area/space)
"wp" = (
/obj/table/reinforced/auto,
/turf/simulated/floor/redblack{
	dir = 4
	},
/area/space)
"xh" = (
/turf/simulated/floor/grey/blackgrime,
/area/station/security/brig/genpop)
"xq" = (
/obj/decal/poster/wallsign/stencil_ru/left/en{
	pixel_x = -18
	},
/obj/decal/poster/wallsign/stencil_ru/right/a{
	pixel_x = -6
	},
/turf/simulated/wall/auto/reinforced/jen/red,
/area/space)
"xs" = (
/obj/disposalpipe/segment/brig{
	dir = 4
	},
/turf/simulated/floor/redblack{
	dir = 8
	},
/area/space)
"xO" = (
/obj/machinery/door/airlock/pyro/security/alt{
	dir = 4
	},
/obj/disposalpipe/segment/brig{
	dir = 4
	},
/turf/simulated/floor/black,
/area/space)
"yl" = (
/obj/machinery/door/airlock/pyro/glass/security{
	req_access = null
	},
/obj/disposalpipe/segment/brig,
/turf/simulated/floor/grime,
/area/station/security/brig/genpop)
"yZ" = (
/turf/simulated/floor/redblack{
	dir = 1
	},
/area/space)
"zA" = (
/obj/decal/poster/wallsign/stencil_ru/left/o,
/obj/decal/poster/wallsign/stencil_ru/right/kha{
	pixel_x = 10
	},
/turf/simulated/wall/auto/reinforced/jen/red,
/area/space)
"zR" = (
/turf/simulated/floor/redblack{
	dir = 1
	},
/area/station/security/processing{
	name = "Security Dispatch"
	})
"zW" = (
/obj/machinery/door/airlock/pyro/security/alt,
/turf/simulated/floor/black,
/area/space)
"AA" = (
/turf/simulated/floor/redblack/corner,
/area/station/security/processing{
	name = "Security Dispatch"
	})
"AF" = (
/obj/machinery/door/airlock/pyro/security/alt,
/turf/simulated/floor/red,
/area/space)
"AX" = (
/turf/simulated/floor/plating/damaged1,
/area/space)
"Bd" = (
/obj/disposalpipe/segment/brig{
	dir = 1;
	icon_state = "pipe-c"
	},
/turf/simulated/floor/redblack{
	dir = 1
	},
/area/space)
"Bo" = (
/obj/submachine/laundry_machine,
/turf/simulated/floor/grime,
/area/space)
"Bu" = (
/obj/disposalpipe/segment/brig,
/turf/simulated/floor/red,
/area/space)
"BG" = (
/obj/submachine/chef_sink/chem_sink{
	desc = "A water-filled unit intended for hand-washing purposes.";
	pixel_y = 8
	},
/turf/simulated/floor/grime,
/area/space)
"BZ" = (
/obj/table/reinforced/auto,
/obj/machinery/door/airlock/pyro/glass/windoor,
/turf/simulated/floor/red,
/area/station/security/processing{
	name = "Security Dispatch"
	})
"CG" = (
/turf/simulated/floor/redblack{
	dir = 9
	},
/area/station/security/processing{
	name = "Security Dispatch"
	})
"CL" = (
/obj/machinery/drainage/big,
/turf/simulated/floor/grime,
/area/space)
"CN" = (
/turf/simulated/floor/black{
	icon_state = "respect1"
	},
/area/space)
"Dj" = (
/obj/item/device/audio_log/wall_mounted{
	pixel_y = 32
	},
/turf/simulated/floor/red,
/area/space)
"Eo" = (
/obj/stool/chair/office/red,
/turf/simulated/floor/redblack,
/area/station/security/processing{
	name = "Security Dispatch"
	})
"EF" = (
/obj/machinery/door/airlock/pyro/security/alt{
	dir = 8
	},
/turf/simulated/floor/red,
/area/station/security/processing{
	name = "Security Dispatch"
	})
"Fw" = (
/turf/simulated/floor/black{
	icon_state = "respect7"
	},
/area/space)
"Hr" = (
/obj/disposalpipe/segment/brig,
/turf/simulated/floor/grime,
/area/station/security/brig/genpop)
"Iq" = (
/obj/table/reinforced/auto,
/turf/simulated/floor/redblack{
	dir = 6
	},
/area/station/security/processing{
	name = "Security Dispatch"
	})
"IF" = (
/turf/simulated/floor/plating/damaged3,
/area/space)
"IS" = (
/obj/disposalpipe/segment/brig{
	dir = 2;
	icon_state = "pipe-c"
	},
/turf/simulated/floor/redblack,
/area/space)
"Jm" = (
/turf/simulated/floor/plating,
/area/space)
"Ki" = (
/obj/machinery/computer/security{
	dir = 4
	},
/turf/simulated/floor/redblack{
	dir = 10
	},
/area/station/security/processing{
	name = "Security Dispatch"
	})
"Kj" = (
/turf/simulated/floor/grime,
/area/space)
"KY" = (
/obj/disposalpipe/segment/brig{
	dir = 4
	},
/turf/simulated/floor/redblack{
	dir = 1
	},
/area/space)
"Ls" = (
/turf/simulated/floor/red,
/area/space)
"Md" = (
/obj/disposalpipe/junction/middle/south,
/turf/simulated/floor/redblack{
	dir = 1
	},
/area/space)
"Nt" = (
/obj/rack,
/turf/simulated/floor/grime,
/area/space)
"NV" = (
/obj/disposalpipe/segment/brig{
	dir = 8;
	icon_state = "pipe-c"
	},
/turf/simulated/floor/redblack{
	dir = 1
	},
/area/space)
"OT" = (
/obj/wingrille_spawn/reinforced_crystal/full,
/obj/disposalpipe/segment/brig,
/turf/simulated/floor/plating,
/area/station/security/brig/genpop)
"Ps" = (
/obj/shrub{
	dir = 1;
	icon = 'icons/obj/stationobjs.dmi';
	icon_state = "plant"
	},
/turf/simulated/floor/redblack{
	dir = 5
	},
/area/station/security/processing{
	name = "Security Dispatch"
	})
"PO" = (
/obj/disposalpipe/segment/brig,
/turf/simulated/floor/black,
/area/space)
"Ql" = (
/turf/simulated/wall/auto/reinforced/jen/red,
/area/space)
"QD" = (
/turf/simulated/floor/redblack/corner,
/area/space)
"QR" = (
/turf/simulated/floor/redblack,
/area/space)
"QV" = (
/turf/simulated/floor/black,
/area/space)
"RD" = (
/obj/stool/chair/red{
	dir = 4
	},
/turf/simulated/floor/black,
/area/space)
"RI" = (
/turf/simulated/floor/redblack{
	dir = 8
	},
/area/space)
"RY" = (
/obj/machinery/door/airlock/pyro/glass/security{
	dir = 4;
	req_access = null
	},
/turf/simulated/floor/red,
/area/station/security/processing{
	name = "Security Dispatch"
	})
"Sy" = (
/turf/simulated/floor/plating/damaged2,
/area/space)
"SD" = (
/turf/simulated/floor/black{
	icon_state = "respect6"
	},
/area/space)
"Ta" = (
/obj/disposalpipe/segment/brig{
	dir = 1;
	icon_state = "pipe-c"
	},
/turf/simulated/floor/red,
/area/space)
"Tl" = (
/obj/wingrille_spawn/reinforced_crystal/full,
/turf/simulated/floor/plating,
/area/station/security/brig/genpop)
"To" = (
/obj/wingrille_spawn/reinforced_crystal/full,
/turf/simulated/floor/plating,
/area/space)
"TU" = (
/obj/disposalpipe/segment/brig{
	dir = 4
	},
/turf/simulated/floor/black,
/area/space)
"VF" = (
/obj/machinery/door/airlock/pyro/glass/security{
	req_access = null
	},
/turf/simulated/floor/red,
/area/station/security/processing{
	name = "Security Dispatch"
	})
"WH" = (
/turf/simulated/floor/black{
	icon_state = "respect3"
	},
/area/space)
"XZ" = (
/obj/stool/chair/office/red{
	dir = 4
	},
/turf/simulated/floor/redblack{
	dir = 4
	},
/area/station/security/processing{
	name = "Security Dispatch"
	})
"Ye" = (
/obj/disposalpipe/segment/brig{
	dir = 4
	},
/turf/simulated/floor/red/redblackchecker,
/area/space)
"Yk" = (
/turf/simulated/wall/auto/reinforced/jen/red,
/area/station/security/processing{
	name = "Security Dispatch"
	})
"Yw" = (
/obj/disposalpipe/segment/brig,
/turf/simulated/floor/redblack,
/area/space)
"ZK" = (
/obj/disposalpipe/trunk/brig{
	dir = 4
	},
/obj/machinery/floorflusher/genpop,
/turf/simulated/floor/grime,
/area/station/security/brig/genpop)
"ZV" = (
/turf/simulated/wall/auto/reinforced/jen/red,
/area/station/security/brig/genpop)

(1,1,1) = {"
lB
lB
lB
lB
lB
lB
lB
lB
lB
lB
lB
lB
lB
lB
lB
lB
lB
lB
lB
lB
lB
Ql
Ql
Ql
Ql
Ql
Ql
Ql
Ql
Sy
aN
QV
QV
QV
aN
"}
(2,1,1) = {"
lB
lB
lB
lB
lB
lB
lB
lB
lB
lB
lB
lB
lB
lB
lB
lB
lB
lB
lB
lB
lB
Ql
yZ
QV
QR
Ql
Bo
Nt
Ql
Ql
Ql
yZ
QV
QV
aN
"}
(3,1,1) = {"
lB
lB
lB
lB
lB
lB
lB
lB
lB
lB
lB
lB
lB
lB
lB
lB
lB
lB
lB
lB
lB
Ql
yZ
QV
QR
Ql
BG
Kj
Kj
nI
Ql
yZ
QV
QV
aN
"}
(4,1,1) = {"
lB
lB
lB
lB
lB
lB
lB
lB
lB
lB
lB
lB
lB
lB
lB
lB
lB
lB
lB
lB
lB
Ql
yZ
QV
QR
lG
CL
Kj
Kj
nI
Ql
yZ
QV
QV
aN
"}
(5,1,1) = {"
lB
lB
lB
lB
lB
lB
lB
lB
lB
lB
lB
lB
lB
lB
lB
lB
lB
lB
lB
lB
lB
Ql
yZ
QV
QR
Ql
Ql
lN
Kj
nI
Ql
yZ
QV
QV
aN
"}
(6,1,1) = {"
lB
lB
lB
lB
lB
lB
lB
lB
lB
lB
lB
lB
lB
lB
lB
lB
lB
lB
lB
lB
lB
Ql
yZ
QV
QR
Ql
Ql
Ql
Ql
Ql
Ql
yZ
QV
QV
aN
"}
(7,1,1) = {"
lB
lB
lB
lB
lB
lB
lB
lB
lB
lB
lB
lB
lB
lB
lB
lB
lB
lB
lB
lB
lB
Ql
yZ
QV
QR
Ql
QV
QV
QV
fJ
Ql
yZ
QV
QV
aN
"}
(8,1,1) = {"
lB
lB
lB
lB
lB
lB
lB
lB
lB
lB
lB
lB
lB
lB
lB
lB
lB
lB
lB
lB
lB
Ql
yZ
QV
QR
zW
QV
RD
QV
cM
Ql
yZ
QV
QV
aN
"}
(9,1,1) = {"
lB
lB
lB
lB
lB
lB
lB
lB
lB
lB
lB
lB
lB
lB
lB
lB
lB
lB
lB
lB
Ql
Ql
yZ
QV
QR
Ql
wp
wp
wp
Ql
Ql
yZ
QV
QV
aN
"}
(10,1,1) = {"
lB
lB
lB
lB
lB
lB
lB
lB
lB
lB
lB
lB
lB
lB
lB
lB
lB
lB
lB
lB
Ql
pY
vS
QV
QR
AF
Ls
eb
eb
Ls
Ql
yZ
QV
QV
aN
"}
(11,1,1) = {"
lB
lB
lB
lB
lB
lB
lB
lB
lB
lB
lB
lB
lB
lB
lB
lB
lB
lB
lB
lB
Ql
yZ
QV
QD
uL
Ql
Dj
Ls
Ls
Ls
Ql
yZ
QV
QV
aN
"}
(12,1,1) = {"
lB
lB
lB
lB
lB
lB
lB
lB
lB
lB
lB
lB
lB
lB
lB
lB
lB
lB
Ql
Ql
Ql
yZ
QV
QR
Yk
Yk
Yk
EF
Yk
Yk
Yk
yZ
QV
QV
aN
"}
(13,1,1) = {"
lB
lB
lB
lB
lB
lB
lB
lB
lB
lB
lB
lB
lB
lB
lB
lB
lB
lB
Ql
pY
RI
vS
QV
QR
Yk
CG
ul
ul
ul
Ki
BZ
yZ
QV
QV
aN
"}
(14,1,1) = {"
lB
lB
lB
lB
lB
lB
lB
lB
lB
lB
lB
lB
lB
lB
lB
lB
lB
lB
Ql
yZ
fJ
fJ
QV
QR
VF
zR
nl
nl
nl
Eo
BZ
yZ
QV
QV
aN
"}
(15,1,1) = {"
lB
lB
lB
lB
lB
lB
lB
lB
lB
lB
lB
lB
lB
lB
lB
lB
lB
lB
Ql
yZ
fJ
fJ
QV
QR
Yk
zR
nl
nl
AA
qg
BZ
yZ
QV
QV
aN
"}
(16,1,1) = {"
lB
lB
lB
lB
lB
lB
lB
lB
lB
lB
lB
lB
lB
lB
lB
lB
lB
lB
Ql
yZ
fJ
fJ
QV
QR
Yk
Ps
ku
XZ
Iq
Yk
Yk
yZ
CN
QV
aN
"}
(17,1,1) = {"
lB
lB
lB
lB
lB
lB
lB
lB
lB
lB
lB
lB
Ql
Ql
Ql
Ql
Ql
Ql
Ql
yZ
QV
QV
QV
QR
Yk
Yk
RY
fi
fi
Yk
pY
vS
vx
QV
aN
"}
(18,1,1) = {"
lB
lB
lB
lB
lB
lB
lB
lB
lB
lB
lB
lB
Ql
RI
RI
RI
RI
RI
RI
vS
QV
QV
QV
QR
Ql
eH
ez
ez
cf
To
yZ
QV
WH
QV
aN
"}
(19,1,1) = {"
lB
lB
lB
lB
lB
lB
lB
lB
lB
lB
lB
lB
Ql
QV
QV
QV
QV
QV
QV
QV
QV
QV
QV
QR
uI
IS
Bu
Ta
yZ
uI
QV
QV
sd
QV
aN
"}
(20,1,1) = {"
lB
lB
lB
lB
lB
lB
lB
lB
lB
lB
lB
lB
Ql
ez
ez
ez
ez
cf
QV
QV
QD
ez
ez
uL
Ql
ue
RI
xs
vS
To
yZ
QV
og
QV
aN
"}
(21,1,1) = {"
lB
lB
lB
lB
lB
lB
lB
lB
lB
lB
lB
lB
Ql
Ql
Ql
Ql
Ql
yZ
QV
QD
uL
ZV
ZV
ZV
ZV
ZV
Ql
xO
Ql
zA
yZ
QV
SD
QV
aN
"}
(22,1,1) = {"
lB
lB
lB
lB
lB
lB
lB
lB
lB
lB
lB
lB
Ql
Kj
Kj
cN
in
Bd
QV
QR
ZV
ZV
cY
cY
cY
Tl
en
TU
en
aG
yZ
QV
Fw
QV
aN
"}
(23,1,1) = {"
lB
lB
lB
lB
lB
lB
lB
lB
lB
lB
lB
lB
Ql
Kj
Kj
Kj
nR
KY
QV
QR
Tl
ZK
cY
cY
cY
Tl
QV
Ye
QV
xq
yZ
QV
QV
QV
aN
"}
(24,1,1) = {"
lB
lB
lB
lB
lB
lB
lB
lB
lB
lB
lB
lB
Ql
Ql
Ql
Ql
Ql
Md
PO
Yw
yl
ik
Hr
Hr
Hr
OT
bz
nM
en
Ql
yZ
QV
QV
QV
aN
"}
(25,1,1) = {"
lB
lB
lB
lB
lB
lB
lB
lB
lB
lB
lB
lB
Ql
Kj
Kj
Kj
nR
KY
QV
QR
Tl
cY
cY
cY
cY
Tl
QV
en
QV
Ql
yZ
QV
QV
QV
aN
"}
(26,1,1) = {"
lB
lB
lB
lB
lB
lB
lB
lB
lB
lB
lB
lB
Ql
Kj
Kj
dD
in
NV
QV
QR
Tl
cY
cY
cY
cY
Tl
en
QV
en
Ql
yZ
QV
QV
QV
aN
"}
(27,1,1) = {"
lB
lB
lB
lB
lB
lB
lB
lB
lB
lB
lB
lB
Ql
Ql
Ql
Ql
Ql
yZ
QV
QR
ZV
ZV
ZV
ZV
ZV
ZV
Ql
Ql
Ql
Ql
yZ
QV
QV
QV
aN
"}
(28,1,1) = {"
lB
lB
lB
lB
lB
lB
lB
lB
lB
lB
lB
lB
lB
lB
lB
lB
Ql
yZ
QV
QR
ZV
xh
xh
xh
xh
ZV
IF
Jm
Jm
aN
aN
QV
QV
QV
aN
"}
(29,1,1) = {"
lB
lB
lB
lB
lB
lB
lB
lB
lB
lB
lB
lB
lB
lB
lB
lB
Ql
yZ
QV
QR
ZV
xh
xh
xh
ZV
ZV
Jm
IF
Jm
Jm
aN
QV
QV
QV
aN
"}
(30,1,1) = {"
lB
lB
lB
lB
lB
lB
lB
lB
lB
lB
lB
lB
lB
lB
lB
lB
Ql
Ql
Ql
Ql
ZV
aA
aA
aA
ZV
AX
Jm
Jm
Jm
AX
aN
QV
QV
QV
aN
"}
